{
    "map": [
        { "row": [0, 0, 0, 0, 0, 0, 0, 0, 0, 0] },
        { "row": [0, 1, 1, 1, 0, 0, 1, 1, 0, 0] },
        { "row": [0, 0, 0, 0, 0, 0, 0, 0, 0, 0] },
        { "row": [0, 0, 1, 1, 0, 1, 0, 0, 1, 0] },
        { "row": [0, 0, 0, 0, 0, 0, 0, 0, 0, 0] },
        { "row": [0, 1, 0, 0, 1, 0, 0, 1, 1, 0] },
        { "row": [0, 0, 0, 0, 0, 0, 0, 0, 0, 0] },
        { "row": [0, 0, 0, 0, 0, 0, 0, 0, 1, 0] },
        { "row": [0, 0, 1, 1, 0, 0, 1, 1, 1, 0] },
        { "row": [0, 0, 0, 0, 0, 0, 0, 0, 0, 0] }
    ],
    "enemies": [
        { "x": 4, "z": 2, "move": "02220444" }
    ],
    "start": [9, 9]
  }